[["#", "#", "#", "#", "#", "#", "#", "#", "#", "#", "#", "#", "#", "#", "#", "#", "#", "#", "#", "#", "#"],
 ["#", " ", " ", " ", " ", " ", "#", " ", " ", " ", "#", " ", " ", " ", " ", " ", "#", " ", " ", " ", "#"],
 ["#", "#", "#", "#", "#", " ", "#", " ", "#", "#", "#", " ", "#", "#", "#", " ", "#", " ", "#", " ", "#"],
 ["#", " ", " ", " ", " ", " ", "#", " ", " ", " ", " ", " ", " ", " ", "#", " ", " ", " ", "#", " ", "#"],
 ["#", " ", "#", "#", "#", "#", "#", "#", "#", "#", "#", " ", "#", " ", "#", "#", "#", " ", "#", " ", "#"],
 ["#", " ", " ", " ", "#", " ", " ", " ", " ", " ", " ", " ", " ", " ", "#", " ", " ", " ", "#", " ", "#"],
 ["#", "#", "#", " ", "#", " ", "#", "#", "#", "#", "#", "#", "#", " ", "#", " ", "#", " ", "#", " ", "#"],
 ["#", " ", " ", " ", "#", " ", "#", " ", " ", " ", " ", " ", " ", " ", " ", " ", "#", " ", " ", " ", "#"],
 ["#", " ", "#", "#", "#", " ", "#", "#", "#", "#", "#", " ", "#", "#", "#", "#", "#", "#", "#", " ", "#"],
 ["#", " ", " ", " ", "#", " ", "#", " ", " ", " ", " ", " ", "#", " ", " ", " ", " ", " ", "#", " ", "#"],
 ["#", "#", "#", " ", "#", " ", "#", " ", "#", " ", "#", " ", "#", " ", "#", "#", "#", " ", "#", "#", "#"],
 ["#", " ", "#", " ", "#", " ", "#", " ", "#", " ", " ", " ", " ", " ", "#", " ", "#", " ", " ", " ", "#"],
 ["#", " ", "#", " ", "#", " ", "#", " ", "#", " ", "#", "#", "#", "#", "#", " ", "#", "#", "#", " ", "#"],
 ["#", " ", "#", " ", "#", " ", "#", " ", " ", " ", " ", " ", "#", " ", " ", " ", "#", " ", " ", " ", "#"],
 ["#", " ", "#", " ", "#", " ", "#", " ", "#", " ", "#", " ", "#", " ", "#", " ", "#", " ", "#", "#", "#"],
 ["#", " ", " ", " ", " ", " ", " ", " ", " ", " ", "#", " ", " ", " ", "#", " ", "#", " ", " ", " ", "#"],
 ["#", " ", "#", "#", "#", "#", "#", "#", "#", "#", "#", "#", "#", "#", "#", " ", "#", "#", "#", " ", "#"],
 ["#", " ", "#", " ", " ", " ", "#", " ", " ", " ", " ", " ", "#", " ", " ", " ", " ", " ", " ", " ", "#"],
 ["#", " ", "#", " ", "#", " ", "#", " ", "#", "#", "#", " ", "#", " ", "#", " ", "#", " ", "#", "#", "#"],
 ["#", " ", " ", " ", "#", " ", " ", " ", "#", " ", " ", " ", " ", " ", "#", " ", " ", " ", " ", "E", "#"],
 ["#", "#", "#", "#", "#", "#", "#", "#", "#", "#", "#", "#", "#", "#", "#", "#", "#", "#", "#", "#", "#"]]