[["#", "#", "#", "#", "#", "#", "#", "#", "#", "#", "#", "#", "#", "#", "#", "#", "#", "#", "#", "#", "#"],
 ["#", " ", "#", " ", " ", " ", " ", " ", "#", " ", " ", " ", " ", " ", " ", " ", " ", " ", " ", " ", "#"],
 ["#", " ", "#", " ", "#", "#", "#", " ", "#", " ", "#", "#", "#", "#", "#", "#", "#", "#", "#", " ", "#"],
 ["#", " ", " ", " ", "#", " ", "#", " ", " ", " ", "#", " ", " ", " ", " ", " ", "#", " ", " ", " ", "#"],
 ["#", "#", "#", "#", "#", " ", "#", " ", "#", " ", "#", "#", "#", " ", "#", "#", "#", " ", "#", " ", "#"],
 ["#", " ", " ", " ", " ", " ", " ", " ", " ", " ", "#", " ", " ", " ", "#", " ", " ", " ", "#", " ", "#"],
 ["#", " ", "#", " ", "#", "#", "#", "#", "#", " ", "#", " ", "#", " ", "#", " ", "#", "#", "#", " ", "#"],
 ["#", " ", " ", " ", " ", " ", " ", " ", " ", " ", " ", " ", "#", " ", "#", " ", " ", " ", "#", " ", "#"],
 ["#", "#", "#", "#", "#", " ", "#", "#", "#", "#", "#", "#", "#", " ", "#", "#", "#", " ", "#", " ", "#"],
 ["#", " ", " ", " ", "#", " ", " ", " ", " ", " ", " ", " ", " ", " ", " ", " ", " ", " ", "#", " ", "#"],
 ["#", "#", "#", " ", "#", "#", "#", "#", "#", "#", "#", " ", "#", " ", "#", " ", "#", "#", "#", " ", "#"],
 ["#", " ", " ", " ", "#", " ", " ", " ", " ", " ", " ", " ", " ", " ", " ", " ", "#", " ", " ", " ", "#"],
 ["#", " ", "#", "#", "#", " ", "#", " ", "#", "#", "#", "#", "#", "#", "#", "#", "#", " ", "#", "#", "#"],
 ["#", " ", " ", " ", " ", " ", "#", " ", " ", " ", " ", " ", " ", " ", " ", " ", "#", " ", " ", " ", "#"],
 ["#", "#", "#", " ", "#", " ", "#", "#", "#", "#", "#", "#", "#", "#", "#", " ", "#", "#", "#", " ", "#"],
 ["#", " ", " ", " ", "#", " ", "#", " ", " ", " ", " ", " ", " ", " ", " ", " ", " ", " ", " ", " ", "#"],
 ["#", " ", "#", "#", "#", " ", "#", "#", "#", "#", "#", " ", "#", " ", "#", "#", "#", " ", "#", "#", "#"],
 ["#", " ", " ", " ", "#", " ", " ", " ", " ", " ", " ", " ", "#", " ", "#", " ", " ", " ", " ", " ", "#"],
 ["#", " ", "#", " ", "#", "#", "#", "#", "#", "#", "#", "#", "#", " ", "#", " ", "#", " ", "#", "#", "#"],
 ["#", " ", "#", " ", " ", " ", " ", " ", " ", " ", " ", " ", " ", " ", " ", " ", " ", " ", " ", "E", "#"],
 ["#", "#", "#", "#", "#", "#", "#", "#", "#", "#", "#", "#", "#", "#", "#", "#", "#", "#", "#", "#", "#"]]