[["#", "#", "#", "#", "#", "#", "#", "#", "#", "#", "#", "#", "#", "#", "#", "#", "#", "#", "#", "#", "#"],
 ["#", " ", " ", " ", " ", " ", " ", " ", "#", " ", " ", " ", " ", " ", "#", " ", " ", " ", " ", " ", "#"],
 ["#", "#", "#", "#", "#", " ", "#", " ", "#", " ", "#", "#", "#", " ", "#", " ", "#", "#", "#", " ", "#"],
 ["#", " ", " ", " ", " ", " ", " ", " ", "#", " ", " ", " ", " ", " ", " ", " ", " ", " ", " ", " ", "#"],
 ["#", " ", "#", "#", "#", "#", "#", "#", "#", "#", "#", " ", "#", "#", "#", " ", "#", "#", "#", " ", "#"],
 ["#", " ", " ", " ", " ", " ", "#", " ", " ", " ", "#", " ", "#", " ", " ", " ", " ", " ", "#", " ", "#"],
 ["#", "#", "#", "#", "#", " ", "#", " ", "#", " ", "#", "#", "#", " ", "#", "#", "#", " ", "#", " ", "#"],
 ["#", " ", " ", " ", "#", " ", "#", " ", "#", " ", " ", " ", "#", " ", " ", " ", "#", " ", " ", " ", "#"],
 ["#", " ", "#", " ", "#", " ", "#", " ", "#", "#", "#", " ", "#", "#", "#", " ", "#", "#", "#", " ", "#"],
 ["#", " ", "#", " ", " ", " ", "#", " ", " ", " ", " ", " ", " ", " ", "#", " ", " ", " ", "#", " ", "#"],
 ["#", " ", "#", "#", "#", "#", "#", " ", "#", "#", "#", "#", "#", " ", "#", " ", "#", " ", "#", " ", "#"],
 ["#", " ", "#", " ", " ", " ", "#", " ", " ", " ", "#", " ", " ", " ", "#", " ", "#", " ", " ", " ", "#"],
 ["#", " ", "#", " ", "#", " ", "#", "#", "#", " ", "#", " ", "#", "#", "#", " ", "#", "#", "#", "#", "#"],
 ["#", " ", "#", " ", "#", " ", "#", " ", " ", " ", " ", " ", "#", " ", " ", " ", " ", " ", " ", " ", "#"],
 ["#", " ", "#", " ", "#", " ", "#", " ", "#", " ", "#", " ", "#", "#", "#", "#", "#", "#", "#", " ", "#"],
 ["#", " ", "#", " ", " ", " ", " ", " ", "#", " ", " ", " ", "#", " ", " ", " ", " ", " ", "#", " ", "#"],
 ["#", " ", "#", " ", "#", "#", "#", "#", "#", " ", "#", "#", "#", " ", "#", " ", "#", " ", "#", " ", "#"],
 ["#", " ", "#", " ", " ", " ", "#", " ", " ", " ", "#", " ", " ", " ", "#", " ", "#", " ", " ", " ", "#"],
 ["#", " ", "#", "#", "#", " ", "#", " ", "#", "#", "#", "#", "#", " ", "#", " ", "#", " ", "#", "#", "#"],
 ["#", " ", " ", " ", " ", " ", "#", " ", " ", " ", " ", " ", " ", " ", "#", " ", " ", " ", " ", "E", "#"],
 ["#", "#", "#", "#", "#", "#", "#", "#", "#", "#", "#", "#", "#", "#", "#", "#", "#", "#", "#", "#", "#"]]