[["#", "#", "#", "#", "#", "#", "#", "#", "#", "#", "#", "#", "#", "#", "#", "#", "#", "#", "#", "#", "#"],
 ["#", " ", "#", " ", " ", " ", " ", " ", " ", " ", " ", " ", " ", " ", "#", " ", " ", " ", " ", " ", "#"],
 ["#", " ", "#", " ", "#", " ", "#", " ", "#", "#", "#", "#", "#", " ", "#", " ", "#", "#", "#", " ", "#"],
 ["#", " ", " ", " ", "#", " ", "#", " ", " ", " ", " ", " ", "#", " ", " ", " ", "#", " ", " ", " ", "#"],
 ["#", "#", "#", " ", "#", " ", "#", " ", "#", "#", "#", " ", "#", "#", "#", "#", "#", " ", "#", " ", "#"],
 ["#", " ", " ", " ", "#", " ", "#", " ", " ", " ", " ", " ", " ", " ", "#", " ", " ", " ", " ", " ", "#"],
 ["#", " ", "#", "#", "#", " ", "#", "#", "#", " ", "#", " ", "#", " ", "#", " ", "#", " ", "#", " ", "#"],
 ["#", " ", " ", " ", "#", " ", " ", " ", " ", " ", "#", " ", "#", " ", " ", " ", " ", " ", " ", " ", "#"],
 ["#", "#", "#", " ", "#", " ", "#", " ", "#", "#", "#", "#", "#", "#", "#", "#", "#", " ", "#", "#", "#"],
 ["#", " ", " ", " ", " ", " ", "#", " ", " ", " ", " ", " ", "#", " ", " ", " ", " ", " ", " ", " ", "#"],
 ["#", " ", "#", "#", "#", " ", "#", "#", "#", " ", "#", " ", "#", " ", "#", " ", "#", "#", "#", "#", "#"],
 ["#", " ", " ", " ", "#", " ", " ", " ", " ", " ", "#", " ", " ", " ", "#", " ", " ", " ", " ", " ", "#"],
 ["#", " ", "#", " ", "#", "#", "#", "#", "#", " ", "#", " ", "#", " ", "#", "#", "#", "#", "#", " ", "#"],
 ["#", " ", "#", " ", " ", " ", " ", " ", "#", " ", "#", " ", " ", " ", " ", " ", "#", " ", " ", " ", "#"],
 ["#", " ", "#", "#", "#", " ", "#", "#", "#", " ", "#", " ", "#", "#", "#", "#", "#", " ", "#", " ", "#"],
 ["#", " ", "#", " ", "#", " ", " ", " ", "#", " ", "#", " ", "#", " ", " ", " ", " ", " ", "#", " ", "#"],
 ["#", " ", "#", " ", "#", "#", "#", " ", "#", " ", "#", " ", "#", " ", "#", "#", "#", "#", "#", " ", "#"],
 ["#", " ", "#", " ", " ", " ", " ", " ", "#", " ", "#", " ", "#", " ", " ", " ", " ", " ", "#", " ", "#"],
 ["#", " ", "#", "#", "#", " ", "#", " ", "#", " ", "#", "#", "#", " ", "#", "#", "#", " ", "#", "#", "#"],
 ["#", " ", " ", " ", " ", " ", "#", " ", " ", " ", " ", " ", " ", " ", " ", " ", " ", " ", " ", "E", "#"],
 ["#", "#", "#", "#", "#", "#", "#", "#", "#", "#", "#", "#", "#", "#", "#", "#", "#", "#", "#", "#", "#"]]