[["#", "#", "#", "#", "#", "#", "#", "#", "#", "#", "#", "#", "#", "#", "#", "#", "#", "#", "#", "#", "#"],
 ["#", " ", "#", " ", " ", " ", " ", " ", " ", " ", " ", " ", "#", " ", " ", " ", " ", " ", " ", " ", "#"],
 ["#", " ", "#", " ", "#", "#", "#", "#", "#", " ", "#", " ", "#", " ", "#", " ", "#", "#", "#", " ", "#"],
 ["#", " ", "#", " ", " ", " ", " ", " ", "#", " ", "#", " ", " ", " ", "#", " ", "#", " ", " ", " ", "#"],
 ["#", " ", "#", "#", "#", "#", "#", "#", "#", " ", "#", " ", "#", " ", "#", " ", "#", " ", "#", "#", "#"],
 ["#", " ", " ", " ", " ", " ", " ", " ", " ", " ", "#", " ", " ", " ", " ", " ", " ", " ", "#", " ", "#"],
 ["#", "#", "#", "#", "#", "#", "#", " ", "#", " ", "#", " ", "#", "#", "#", "#", "#", " ", "#", " ", "#"],
 ["#", " ", " ", " ", " ", " ", "#", " ", " ", " ", "#", " ", " ", " ", " ", " ", "#", " ", "#", " ", "#"],
 ["#", "#", "#", " ", "#", " ", "#", " ", "#", " ", "#", " ", "#", " ", "#", " ", "#", " ", "#", " ", "#"],
 ["#", " ", " ", " ", " ", " ", "#", " ", " ", " ", "#", " ", "#", " ", "#", " ", " ", " ", " ", " ", "#"],
 ["#", " ", "#", "#", "#", "#", "#", "#", "#", " ", "#", " ", "#", "#", "#", " ", "#", " ", "#", " ", "#"],
 ["#", " ", " ", " ", " ", " ", " ", " ", " ", " ", " ", " ", " ", " ", " ", " ", " ", " ", " ", " ", "#"],
 ["#", "#", "#", " ", "#", " ", "#", " ", "#", " ", "#", " ", "#", " ", "#", "#", "#", " ", "#", " ", "#"],
 ["#", " ", " ", " ", "#", " ", "#", " ", "#", " ", "#", " ", "#", " ", " ", " ", "#", " ", " ", " ", "#"],
 ["#", " ", "#", " ", "#", " ", "#", " ", "#", " ", "#", " ", "#", "#", "#", " ", "#", "#", "#", " ", "#"],
 ["#", " ", "#", " ", "#", " ", "#", " ", " ", " ", " ", " ", " ", " ", "#", " ", " ", " ", " ", " ", "#"],
 ["#", " ", "#", "#", "#", " ", "#", "#", "#", "#", "#", "#", "#", " ", "#", " ", "#", "#", "#", " ", "#"],
 ["#", " ", " ", " ", "#", " ", "#", " ", " ", " ", "#", " ", " ", " ", " ", " ", "#", " ", " ", " ", "#"],
 ["#", " ", "#", " ", "#", " ", "#", " ", "#", " ", "#", " ", "#", "#", "#", "#", "#", " ", "#", " ", "#"],
 ["#", " ", "#", " ", " ", " ", " ", " ", "#", " ", "#", " ", " ", " ", " ", " ", " ", " ", "#", "E", "#"],
 ["#", "#", "#", "#", "#", "#", "#", "#", "#", "#", "#", "#", "#", "#", "#", "#", "#", "#", "#", "#", "#"]]