[["#", "#", "#", "#", "#", "#", "#", "#", "#", "#", "#", "#", "#", "#", "#", "#", "#", "#", "#", "#", "#"],
 ["#", " ", " ", " ", " ", " ", " ", " ", "#", " ", " ", " ", "#", " ", " ", " ", " ", " ", " ", " ", "#"],
 ["#", "#", "#", "#", "#", "#", "#", " ", "#", " ", "#", " ", "#", " ", "#", "#", "#", "#", "#", " ", "#"],
 ["#", " ", " ", " ", " ", " ", "#", " ", " ", " ", "#", " ", "#", " ", " ", " ", " ", " ", "#", " ", "#"],
 ["#", " ", "#", " ", "#", "#", "#", "#", "C", "C", "C", " ", "C", "C", "C", "C", "C", "C", "C", " ", "C"],
 ["#", " ", "#", " ", " ", " ", " ", " ", "C", " ", " ", " ", " ", " ", " ", " ", " ", " ", " ", " ", "C"],
 ["#", " ", "#", "#", "#", " ", "#", "#", "C", " ", " ", " ", " ", " ", " ", " ", " ", " ", " ", " ", "C"],
 ["#", " ", " ", " ", "#", " ", "#", " ", " ", " ", " ", " ", " ", " ", " ", " ", " ", " ", " ", " ", "C"],
 ["#", "#", "#", " ", "#", " ", "#", " ", "C", " ", " ", " ", " ", " ", " ", " ", " ", " ", " ", " ", "C"],
 ["#", " ", " ", " ", "#", " ", " ", " ", "C", " ", " ", " ", " ", " ", " ", " ", " ", " ", " ", " ", "C"],
 ["C", " ", "C", "C", "C", "C", "C", "#", "C", " ", " ", " ", " ", " ", " ", " ", " ", " ", " ", " ", "C"],
 ["C", " ", " ", " ", " ", " ", " ", " ", "C", " ", " ", " ", " ", " ", " ", " ", " ", " ", " ", " ", "C"],
 ["C", " ", " ", " ", " ", " ", "C", " ", "C", " ", " ", " ", " ", " ", " ", " ", " ", " ", " ", " ", "C"],
 ["C", " ", " ", " ", " ", " ", "C", " ", "C", " ", " ", " ", " ", " ", " ", " ", " ", " ", " ", " ", "C"],
 ["C", " ", " ", " ", " ", " ", "C", " ", "C", "C", "C", "C", "C", "C", "C", "C", "C", "C", "C", "C", "C"],
 ["C", " ", " ", " ", " ", " ", "C", " ", " ", " ", "#", " ", " ", " ", " ", " ", " ", " ", " ", " ", "#"],
 ["C", " ", " ", " ", " ", " ", "C", "#", "#", " ", "#", " ", "#", "#", "#", "#", "#", "#", "#", " ", "#"],
 ["C", " ", " ", " ", " ", " ", "C", " ", " ", " ", "#", " ", " ", " ", "#", " ", " ", " ", "#", " ", "#"],
 ["C", "C", "C", "C", "C", "C", "C", " ", "#", "#", "#", "#", "#", "#", "#", " ", "#", " ", "#", " ", "#"],
 ["#", " ", " ", " ", " ", " ", " ", " ", " ", " ", " ", " ", " ", " ", " ", " ", "#", " ", " ", "E", "#"],
 ["#", "#", "#", "#", "#", "#", "#", "#", "#", "#", "#", "#", "#", "#", "#", "#", "#", "#", "#", "#", "#"]]