[["#","#","B","B","#"],
 ["#"," "," "," ","B"],
 ["#"," "," "," ","B"],
 ["#"," "," ","E","#"],
 ["#","#","#","#","#"]]