[["#", "#", "#", "#", "#", "#", "#", "#", "#", "#", "#", "#", "#", "#", "#", "#", "#", "#", "#", "#", "#"],
 ["#", " ", " ", " ", " ", " ", "#", " ", " ", " ", " ", " ", " ", " ", "#", " ", " ", " ", " ", " ", "#"],
 ["#", "#", "#", "#", "#", " ", "#", " ", "#", " ", "#", " ", "#", " ", "#", " ", "#", "#", "#", " ", "#"],
 ["#", " ", " ", " ", "#", " ", " ", " ", " ", " ", " ", " ", " ", " ", " ", " ", "#", " ", "#", " ", "#"],
 ["#", " ", "#", " ", "#", "#", "#", " ", "#", "#", "#", "#", "#", " ", "#", "#", "#", " ", "#", " ", "#"],
 ["#", " ", "#", " ", "#", " ", " ", " ", " ", " ", " ", " ", " ", " ", "#", " ", " ", " ", "#", " ", "#"],
 ["#", " ", "#", " ", "#", " ", "#", " ", "#", " ", "#", "#", "#", " ", "#", "#", "#", " ", "#", " ", "#"],
 ["#", " ", "#", " ", " ", " ", "#", " ", " ", " ", "#", " ", "#", " ", " ", " ", " ", " ", "#", " ", "#"],
 ["#", " ", "#", "#", "#", "#", "#", " ", "#", "#", "#", " ", "#", " ", "#", "#", "#", "#", "#", " ", "#"],
 ["#", " ", " ", " ", " ", " ", " ", " ", "#", " ", " ", " ", " ", " ", "#", " ", " ", " ", " ", " ", "#"],
 ["#", "#", "#", " ", "#", " ", "#", " ", "#", "#", "#", "#", "#", "#", "#", " ", "#", " ", "#", "#", "#"],
 ["#", " ", " ", " ", " ", " ", "#", " ", " ", " ", " ", " ", " ", " ", "#", " ", " ", " ", " ", " ", "#"],
 ["#", " ", "#", "#", "#", " ", "#", " ", "#", "#", "#", "#", "#", " ", "#", " ", "#", " ", "#", " ", "#"],
 ["#", " ", " ", " ", "#", " ", " ", " ", " ", " ", " ", " ", "#", " ", " ", " ", " ", " ", "#", " ", "#"],
 ["#", "#", "#", " ", "#", " ", "#", " ", "#", "#", "#", " ", "#", " ", "#", "#", "#", " ", "#", " ", "#"],
 ["#", " ", " ", " ", " ", " ", " ", " ", " ", " ", "#", " ", "#", " ", " ", " ", " ", " ", "#", " ", "#"],
 ["#", " ", "#", "#", "#", "#", "#", " ", "#", " ", "#", " ", "#", "#", "#", " ", "#", "#", "#", " ", "#"],
 ["#", " ", " ", " ", " ", " ", " ", " ", "#", " ", "#", " ", " ", " ", " ", " ", " ", " ", " ", " ", "#"],
 ["#", "#", "#", " ", "#", " ", "#", "#", "#", " ", "#", "#", "#", " ", "#", "#", "#", "#", "#", "#", "#"],
 ["#", " ", " ", " ", " ", " ", "#", " ", " ", " ", " ", " ", " ", " ", " ", " ", " ", " ", " ", "E", "#"],
 ["#", "#", "#", "#", "#", "#", "#", "#", "#", "#", "#", "#", "#", "#", "#", "#", "#", "#", "#", "#", "#"]]