[[" "," "," "," "," "],
 [" "," "," "," "," "],
 [" "," ","#"," "," "],
 [" "," ","#"," "," "],
 [" "," "," "," "," "]]