[["#", "#", "#", "#", "#", "#", "#", "#", "#", "#", "#", "#", "#", "#", "#", "#", "#", "#", "#", "#", "#"],
 ["#", " ", "#", " ", " ", " ", "#", " ", " ", " ", "#", " ", " ", " ", " ", " ", " ", " ", " ", " ", "#"],
 ["#", " ", "#", " ", "#", "#", "#", " ", "#", " ", "#", " ", "#", " ", "#", "#", "#", "#", "#", " ", "#"],
 ["#", " ", "#", " ", "#", " ", " ", " ", " ", " ", " ", " ", " ", " ", "#", " ", "#", " ", " ", " ", "#"],
 ["#", " ", "#", " ", "#", " ", "#", "#", "#", "#", "#", "#", "#", " ", "#", " ", "#", " ", "#", "#", "#"],
 ["#", " ", "#", " ", " ", " ", " ", " ", "#", " ", " ", " ", " ", " ", "#", " ", " ", " ", " ", " ", "#"],
 ["#", " ", "#", " ", "#", "#", "#", "#", "#", " ", "#", "#", "#", "#", "#", " ", "#", " ", "#", " ", "#"],
 ["#", " ", " ", " ", " ", " ", " ", " ", "#", " ", " ", " ", "#", " ", "#", " ", " ", " ", "#", " ", "#"],
 ["#", "#", "#", " ", "#", "#", "#", " ", "#", "#", "#", " ", "#", " ", "#", " ", "#", " ", "#", " ", "#"],
 ["#", " ", " ", " ", " ", " ", "#", " ", " ", " ", " ", " ", "#", " ", " ", " ", "#", " ", "#", " ", "#"],
 ["#", " ", "#", " ", "#", "#", "#", "#", "#", " ", "#", " ", "#", " ", "#", "#", "#", " ", "#", " ", "#"],
 ["#", " ", " ", " ", " ", " ", " ", " ", " ", " ", "#", " ", " ", " ", " ", " ", "#", " ", " ", " ", "#"],
 ["#", " ", "#", " ", "#", " ", "#", "#", "#", " ", "#", " ", "#", "#", "#", " ", "#", "#", "#", " ", "#"],
 ["#", " ", "#", " ", " ", " ", "#", " ", " ", " ", " ", " ", "#", " ", "#", " ", " ", " ", " ", " ", "#"],
 ["#", " ", "#", "#", "#", " ", "#", " ", "#", "#", "#", " ", "#", " ", "#", " ", "#", "#", "#", " ", "#"],
 ["#", " ", " ", " ", "#", " ", "#", " ", " ", " ", "#", " ", " ", " ", " ", " ", " ", " ", "#", " ", "#"],
 ["#", " ", "#", " ", "#", " ", "#", " ", "#", " ", "#", " ", "#", "#", "#", "#", "#", "#", "#", " ", "#"],
 ["#", " ", " ", " ", "#", " ", " ", " ", "#", " ", "#", " ", "#", " ", " ", " ", " ", " ", " ", " ", " "],
 ["#", " ", "#", "#", "#", "#", "#", " ", "#", " ", "#", " ", "#", " ", "#", " ", "#", "#", "#", " ", "#"],
 ["#", " ", " ", " ", " ", " ", " ", " ", " ", " ", " ", " ", " ", " ", " ", " ", " ", " ", " ", "E", "#"],
 ["#", "#", "#", "#", "#", "#", "#", " ", "#", "#", "#", "#", "#", "#", "#", "#", "#", "#", "#", "#", "#"]]