[["#","#","#","#","#"],
 ["#"," "," "," ","#"],
 ["#"," "," "," ","#"],
 ["#"," "," "," ","#"],
 ["#","#","#","#","#"]]