[["#", "#", "#", "#", "#", "#", "#", "#", "#", "#", "#", "#", "#", "#", "#", "#", "#", "#", "#", "#", "#"],
 ["#", " ", "#", " ", " ", " ", " ", " ", " ", " ", " ", " ", " ", " ", "#", " ", " ", " ", " ", " ", "#"],
 ["#", " ", "#", "#", "#", "#", "#", " ", "#", "#", "#", " ", "#", " ", "#", " ", "#", "#", "#", " ", "#"],
 ["#", " ", "#", " ", " ", " ", " ", " ", "#", " ", " ", " ", "#", " ", "#", " ", " ", " ", " ", " ", "#"],
 ["#", " ", "#", " ", "#", " ", "#", "#", "#", " ", "#", " ", "#", " ", "#", " ", "#", "#", "#", " ", "#"],
 ["#", " ", " ", " ", "#", " ", " ", " ", " ", " ", "#", " ", "#", " ", "#", " ", " ", " ", " ", " ", "#"],
 ["#", "#", "#", "#", "#", " ", "#", " ", "#", " ", "#", " ", "#", " ", "#", "#", "#", " ", "#", "#", "#"],
 ["#", " ", " ", " ", " ", " ", " ", " ", "#", " ", " ", " ", "#", " ", " ", " ", "#", " ", " ", " ", "#"],
 ["#", " ", "#", " ", "#", " ", "#", "#", "#", " ", "#", " ", "#", " ", "#", " ", "#", " ", "#", " ", "#"],
 ["#", " ", " ", " ", " ", " ", "#", " ", " ", " ", " ", " ", "#", " ", " ", " ", " ", " ", " ", " ", "#"],
 ["#", "#", "#", " ", "#", " ", "#", "#", "#", "#", "#", " ", "#", " ", "#", "#", "#", " ", "#", " ", "#"],
 ["#", " ", " ", " ", " ", " ", " ", " ", "#", " ", " ", " ", " ", " ", " ", " ", " ", " ", " ", " ", "#"],
 ["#", " ", "#", "#", "#", " ", "#", " ", "#", " ", "#", " ", "#", " ", "#", "#", "#", " ", "#", " ", "#"],
 ["#", " ", "#", " ", " ", " ", "#", " ", "#", " ", " ", " ", " ", " ", "#", " ", " ", " ", "#", " ", "#"],
 ["#", " ", "#", " ", "#", " ", "#", " ", "#", "#", "#", " ", "#", "#", "#", " ", "#", "#", "#", " ", "#"],
 ["#", " ", "#", " ", "#", " ", " ", " ", " ", " ", " ", " ", " ", " ", "#", " ", "#", " ", " ", " ", "#"],
 ["#", " ", "#", " ", "#", " ", "#", " ", "#", "#", "#", "#", "#", " ", "#", " ", "#", " ", "#", " ", "#"],
 ["#", " ", "#", " ", " ", " ", " ", " ", " ", " ", " ", " ", "#", " ", " ", " ", " ", " ", " ", " ", "#"],
 ["#", " ", "#", "#", "#", "#", "#", "#", "#", "#", "#", " ", "#", " ", "#", " ", "#", " ", "#", "#", "#"],
 ["#", " ", " ", " ", " ", " ", " ", " ", " ", " ", " ", " ", "#", " ", " ", " ", " ", " ", " ", "E", "#"],
 ["#", "#", "#", " ", "#", "#", "#", "#", "#", "#", "#", " ", "#", "#", "#", "#", "#", "#", "#", " ", "#"]]