[["#", "#", "#", "#", "#", "#", "#", "#", "#", "#", "#", "#", "#", "#", "#", "#", "#", "#", "#", "#", "#"],
 ["#", " ", " ", " ", " ", " ", "#", " ", " ", " ", " ", " ", " ", " ", " ", " ", " ", " ", "#", " ", "#"],
 ["#", "#", "#", "#", "#", " ", "#", " ", "#", " ", "#", "#", "#", "#", "#", "#", "#", " ", "#", " ", "#"],
 ["#", " ", " ", " ", "#", " ", "#", " ", "#", " ", " ", " ", "#", " ", " ", " ", "#", " ", "#", " ", "#"],
 ["#", " ", "#", "#", "#", " ", "#", " ", "#", "#", "#", " ", "#", " ", "#", "#", "#", " ", "#", " ", "#"],
 ["#", " ", " ", " ", " ", " ", "#", " ", " ", " ", "#", " ", "#", " ", " ", " ", "#", " ", " ", " ", "#"],
 ["#", " ", "#", "#", "#", "#", "#", " ", "#", "#", "#", " ", "#", " ", "#", " ", "#", "#", "#", " ", "#"],
 ["#", " ", " ", " ", "#", " ", " ", " ", " ", " ", "#", " ", "#", " ", "#", " ", " ", " ", "#", " ", "#"],
 ["#", "#", "#", " ", "#", "#", "#", " ", "#", " ", "#", " ", "#", " ", "#", " ", "#", " ", "#", " ", "#"],
 ["#", " ", "#", " ", " ", " ", " ", " ", " ", " ", "#", " ", "#", " ", "#", " ", " ", " ", " ", " ", "#"],
 ["#", " ", "#", "#", "#", "#", "#", "#", "#", " ", "#", " ", "#", "#", "#", " ", "#", "#", "#", "#", "#"],
 ["#", " ", "#", " ", " ", " ", "#", " ", " ", " ", " ", " ", " ", " ", "#", " ", " ", " ", " ", " ", "#"],
 ["#", " ", "#", " ", "#", " ", "#", " ", "#", "#", "#", "#", "#", " ", "#", "#", "#", "#", "#", " ", "#"],
 ["#", " ", "#", " ", "#", " ", "#", " ", " ", " ", " ", " ", " ", " ", " ", " ", " ", " ", "#", " ", "#"],
 ["#", " ", "#", " ", "#", " ", "#", " ", "#", "#", "#", "#", "#", " ", "#", "#", "#", " ", "#", " ", "#"],
 ["#", " ", "#", " ", "#", " ", " ", " ", " ", " ", " ", " ", " ", " ", " ", " ", " ", " ", "#", " ", "#"],
 ["#", " ", "#", " ", "#", "#", "#", "#", "#", " ", "#", " ", "#", "#", "#", " ", "#", "#", "#", " ", "#"],
 ["#", " ", " ", " ", "#", " ", " ", " ", " ", " ", "#", " ", " ", " ", " ", " ", "#", " ", " ", " ", "#"],
 ["#", " ", "#", "#", "#", " ", "#", "#", "#", " ", "#", " ", "#", "#", "#", " ", "#", " ", "#", "#", "#"],
 ["#", " ", " ", " ", "#", " ", " ", " ", " ", " ", " ", " ", " ", " ", " ", " ", " ", " ", " ", "E", "#"],
 ["#", "#", "#", "#", "#", "#", "#", "#", "#", "#", "#", "#", "#", "#", "#", "#", "#", "#", "#", "#", "#"]]