[["#","#","#","#","#","#","#","#","#","#","#","#","#","#","#"],
 ["#"," "," "," "," "," "," "," "," "," "," "," "," "," ","#"],
 ["#"," "," "," "," "," "," "," "," "," "," "," "," "," ","#"],
 ["#"," "," "," "," "," "," "," "," "," "," "," "," "," ","#"],
 ["#"," "," "," "," "," "," "," "," "," "," "," "," "," ","#"],
 ["#"," "," "," ","#"," "," "," "," "," ","#"," "," "," ","#"],
 ["#"," "," "," "," "," "," "," "," "," "," "," "," "," ","#"],
 ["#"," "," "," "," "," "," "," "," "," "," "," "," "," ","#"],
 ["#"," "," "," "," "," "," "," "," "," "," "," "," "," ","#"],
 ["#"," "," "," "," "," "," "," "," "," "," "," "," "," ","#"],
 ["#"," "," "," "," "," "," "," "," "," "," "," "," "," ","#"],
 ["#"," "," "," "," "," "," "," "," "," "," "," "," "," ","#"],
 ["#"," "," "," "," "," "," "," "," "," "," "," "," "," ","#"],
 ["#"," "," "," "," "," "," "," "," "," "," "," "," "," ","#"],
 ["#"," "," "," "," "," "," "," "," "," "," "," "," "," ","#"],
 ["#"," "," "," "," "," "," "," "," "," "," "," "," "," ","#"],
 ["#"," "," "," "," "," "," "," "," "," "," "," "," "," ","#"],
 ["#"," "," "," "," "," "," "," "," "," ","E"," "," "," ","#"],
 ["#"," "," "," "," "," "," "," "," "," "," "," "," "," ","#"],
 ["#"," "," "," "," "," "," "," "," "," "," "," "," "," ","#"],
 ["#","#","#","#","#","#","#","#","#","#","#","#","#","#","#"]]
