[["#", "#", "#", "#", "#", "#", "#", "#", "#", "#", "#", "#", "#", "#", "#", "#", "#", "#", "#", "#", "#"],
 ["#", " ", "#", " ", " ", " ", "#", " ", " ", " ", "#", " ", " ", " ", " ", " ", " ", " ", "#", " ", "#"],
 ["#", " ", "#", "#", "#", " ", "#", " ", "#", " ", "#", " ", "#", " ", "#", "#", "#", " ", "#", " ", "#"],
 ["#", " ", "#", " ", " ", " ", "#", " ", "#", " ", " ", " ", "#", " ", "#", " ", " ", " ", "#", " ", "#"],
 ["#", " ", "M", " ", "M", "M", "M", " ", "M", "C", "C", "C", "C", " ", "C", "C", "C", " ", "#", " ", "#"],
 ["#", " ", "M", " ", " ", " ", " ", " ", "M", " ", " ", " ", " ", " ", " ", " ", "C", " ", " ", " ", "#"],
 ["#", " ", "M", " ", " ", " ", " ", " ", "M", " ", " ", " ", " ", " ", " ", " ", "C", "#", "#", " ", "#"],
 ["#", " ", "M", " ", " ", " ", " ", " ", "M", " ", " ", " ", " ", " ", " ", " ", "C", " ", " ", " ", "#"],
 ["#", " ", "M", " ", " ", " ", " ", " ", "M", " ", " ", " ", " ", " ", " ", " ", "C", " ", "#", "#", "#"],
 ["#", " ", "M", " ", " ", " ", " ", " ", "M", " ", " ", " ", " ", " ", " ", " ", "C", " ", "#", " ", "#"],
 ["#", " ", "M", "M", "M", "M", "M", " ", "M", " ", " ", " ", " ", " ", " ", " ", "C", " ", "#", " ", "#"],
 ["#", " ", "#", " ", " ", " ", " ", " ", "C", " ", " ", " ", " ", " ", " ", " ", "C", " ", "#", " ", "#"],
 ["#", " ", "#", " ", "#", "#", "#", "#", "C", " ", " ", " ", " ", " ", " ", " ", "C", " ", "#", " ", "#"],
 ["#", " ", "#", " ", "#", " ", " ", " ", "C", " ", " ", " ", " ", " ", " ", " ", "C", " ", " ", " ", "#"],
 ["#", " ", "#", " ", "#", " ", "#", " ", "C", " ", " ", " ", " ", " ", " ", " ", "C", "#", "#", " ", "#"],
 ["#", " ", "#", " ", " ", " ", "#", " ", "C", " ", " ", " ", " ", " ", " ", " ", "C", " ", " ", " ", "#"],
 ["#", " ", "#", "#", "#", "#", "#", "#", "C", "C", "C", " ", "C", "C", "C", "C", "C", " ", "#", "#", "#"],
 ["#", " ", " ", " ", "#", " ", " ", " ", " ", " ", " ", " ", "#", " ", " ", " ", "#", " ", " ", " ", "#"],
 ["#", "#", "#", " ", "#", " ", "#", "#", "#", "#", "#", "#", "#", " ", "#", " ", "#", "#", "#", " ", "#"],
 ["#", " ", " ", " ", " ", " ", "#", " ", " ", " ", " ", " ", " ", " ", "#", " ", " ", " ", " ", "E", "#"],
 ["#", "#", "#", "#", "#", "#", "#", "#", "#", "#", "#", "#", "#", "#", "#", "#", "#", "#", "#", "#", "#"]]