[["#","#","#","#","#","#","#"],
 ["#"," "," "," "," "," ","#"],
 ["#"," "," "," "," "," ","#"],
 ["#"," "," ","#"," "," ","#"],
 ["#"," "," "," "," "," ","#"],
 ["#"," "," "," "," "," ","#"],
 ["#","#","#","#","#","#","#"]]