[["#","#","#","#","#","#","#","#","#","#","#","#","#","#","#"],
 ["#"," "," "," "," "," "," "," "," "," "," "," "," "," ","#"],
 ["#"," "," "," "," "," "," "," "," "," "," "," "," "," ","#"],
 ["#"," "," "," "," "," "," "," "," "," "," "," "," "," ","#"],
 ["#"," "," "," "," "," "," "," "," "," "," "," "," "," ","#"],
 ["#"," "," "," "," "," "," "," "," "," "," "," "," "," ","#"],
 ["#"," "," "," "," "," "," "," "," "," "," "," "," "," ","#"],
 ["#"," "," "," "," "," "," "," "," "," "," "," "," "," ","#"],
 ["#"," "," "," "," "," "," "," "," "," "," "," "," "," ","#"],
 ["#"," "," "," "," "," "," "," "," "," "," "," "," "," ","#"],
 ["#"," "," "," "," "," "," "," "," "," "," "," "," "," ","#"],
 ["#"," "," "," "," "," "," "," "," "," "," "," "," "," ","#"],
 ["#"," "," "," "," "," "," "," "," "," "," "," "," "," ","#"],
 ["#"," "," "," "," "," "," "," "," "," "," "," "," "," ","#"],
 ["#"," "," "," "," "," "," "," "," "," "," "," "," "," ","#"],
 ["#"," "," "," "," "," "," "," "," "," "," "," "," "," ","#"],
 ["#"," "," "," "," "," "," "," "," "," "," "," "," "," ","#"],
 ["#"," "," "," "," "," "," "," "," "," "," "," "," "," ","#"],
 ["#"," "," "," "," "," "," "," "," "," "," "," "," "," ","#"],
 ["#"," "," "," "," "," "," "," "," "," "," "," "," "," ","#"],
 ["#","#","#","#","#","#","#","#","#","#","#","#","#","#","#"]]
