[["#", "#", "#", "#", "#", "#", "#", "#", "#", "#", "#", "#", "#", "#", "#", "#", "#", "#", "#", "#", "#"],
 ["#", " ", "#", " ", " ", " ", " ", " ", " ", " ", " ", " ", " ", " ", "#", " ", " ", " ", " ", " ", "#"],
 ["#", " ", "#", " ", "#", " ", "#", "#", "#", "#", "#", "#", "#", " ", "#", "#", "#", " ", "#", " ", "#"],
 ["#", " ", "#", " ", "#", " ", "#", " ", " ", " ", "#", " ", " ", " ", "#", " ", " ", " ", "#", " ", "#"],
 ["#", " ", "#", "#", "#", " ", "#", " ", "#", " ", "#", " ", "#", "#", "#", " ", "#", "#", "#", " ", "#"],
 ["#", " ", "#", " ", " ", " ", "#", " ", " ", " ", "#", " ", " ", " ", " ", " ", " ", " ", "#", " ", "#"],
 ["#", " ", "#", " ", "#", "#", "#", " ", "#", " ", "#", " ", "#", "#", "#", "#", "#", " ", "#", " ", "#"],
 ["#", " ", "#", " ", " ", " ", "#", " ", "#", " ", " ", " ", "#", " ", " ", " ", " ", " ", " ", " ", "#"],
 ["#", " ", "#", "#", "#", " ", "#", " ", "#", " ", "#", " ", "#", " ", "#", "#", "#", "#", "#", "#", "#"],
 ["#", " ", "#", " ", " ", " ", " ", " ", " ", " ", " ", " ", "#", " ", " ", " ", "#", " ", " ", " ", "#"],
 ["#", " ", "#", " ", "#", "#", "#", " ", "#", "#", "#", " ", "#", "#", "#", " ", "#", " ", "#", " ", "#"],
 ["#", " ", "#", " ", " ", " ", "#", " ", " ", " ", "#", " ", "#", " ", "#", " ", "#", " ", "#", " ", "#"],
 ["#", " ", "#", "#", "#", " ", "#", " ", "#", " ", "#", " ", "#", " ", "#", " ", "#", " ", "#", " ", "#"],
 ["#", " ", " ", " ", " ", " ", " ", " ", " ", " ", "#", " ", " ", " ", " ", " ", "#", " ", "#", " ", "#"],
 ["#", "#", "#", "#", "#", "#", "#", " ", "#", " ", "#", "#", "#", "#", "#", " ", "#", " ", "#", "#", "#"],
 ["#", " ", " ", " ", " ", " ", " ", " ", " ", " ", "#", " ", " ", " ", " ", " ", "#", " ", " ", " ", "#"],
 ["#", " ", "#", " ", "#", "#", "#", "#", "#", " ", "#", " ", "#", "#", "#", "#", "#", "#", "#", " ", "#"],
 ["#", " ", "#", " ", "#", " ", " ", " ", "#", " ", "#", " ", "#", " ", " ", " ", " ", " ", " ", " ", "#"],
 ["#", " ", "#", " ", "#", " ", "#", " ", "#", "#", "#", " ", "#", " ", "#", "#", "#", " ", "#", " ", "#"],
 ["#", " ", " ", " ", " ", " ", "#", " ", " ", " ", " ", " ", " ", " ", "#", " ", " ", " ", "#", "E", "#"],
 ["#", "#", "#", "#", "#", "#", "#", "#", "#", "#", "#", "#", "#", "#", "#", "#", "#", "#", "#", "#", "#"]]