[["#", "#", "#", "#", "#", "#", "#", "#", "#", "#", "#", "#", "#", "#", "#", "#", "#", "#", "#", "#", "#"],
 ["#", " ", " ", " ", " ", " ", " ", " ", " ", " ", "#", " ", " ", " ", " ", " ", "#", " ", " ", " ", "#"],
 ["#", "#", "#", "#", "#", "#", "#", "#", "#", " ", "#", " ", "#", "#", "#", " ", "#", " ", "#", " ", "#"],
 ["#", " ", "#", " ", " ", " ", " ", " ", " ", " ", " ", " ", " ", " ", "#", " ", "#", " ", "#", " ", "#"],
 ["#", " ", "#", " ", " ", " ", " ", " ", " ", " ", " ", " ", " ", " ", "#", " ", "#", "#", "#", " ", "#"],
 ["#", " ", "#", " ", " ", " ", " ", " ", " ", " ", " ", " ", " ", " ", "#", " ", " ", " ", " ", " ", "#"],
 ["#", " ", "#", " ", " ", " ", " ", " ", " ", " ", " ", " ", " ", " ", "#", "#", "#", "#", "#", " ", "#"],
 ["#", " ", "#", " ", " ", " ", " ", " ", " ", " ", " ", " ", " ", " ", "#", " ", "#", " ", " ", " ", "#"],
 ["#", " ", "#", " ", " ", " ", " ", " ", " ", " ", " ", " ", " ", " ", "#", " ", "#", " ", "#", "#", "#"],
 ["#", " ", "#", " ", " ", " ", " ", " ", " ", " ", " ", " ", " ", " ", "#", " ", " ", " ", "#", " ", "#"],
 ["#", " ", "#", "#", "#", "#", "#", "#", "B", "B", "B", "B", "B", "B", "B", " ", "B", "B", "B", " ", "B"],
 ["#", " ", " ", " ", " ", " ", " ", " ", "B", " ", " ", " ", " ", " ", " ", " ", " ", " ", " ", " ", "B"],
 ["#", " ", "#", "#", "#", "#", "#", "#", "B", " ", " ", " ", " ", " ", " ", " ", " ", " ", " ", " ", "B"],
 ["#", " ", " ", " ", " ", " ", " ", " ", "B", " ", " ", " ", " ", " ", " ", " ", " ", " ", " ", " ", "B"],
 ["B", "B", "B", "B", "B", "B", "B", " ", "B", " ", " ", " ", " ", " ", " ", " ", " ", " ", " ", " ", "B"],
 ["B", " ", " ", " ", " ", " ", " ", " ", "B", " ", " ", " ", " ", " ", " ", " ", " ", " ", " ", " ", "B"],
 ["B", " ", " ", " ", " ", " ", " ", " ", "B", " ", " ", " ", " ", " ", " ", " ", " ", " ", " ", " ", "B"],
 ["B", " ", " ", " ", " ", " ", " ", " ", "B", " ", " ", " ", " ", " ", " ", " ", " ", " ", " ", " ", "B"],
 ["B", " ", " ", " ", " ", " ", " ", " ", "B", "B", "B", "B", "B", "B", "B", "B", "B", " ", "B", "B", "B"],
 ["B", " ", " ", " ", " ", " ", " ", " ", " ", " ", " ", " ", " ", " ", " ", " ", " ", " ", " ", "E", "#"],
 ["B", "B", "B", "B", "B", "B", "B", "B", "B", "#", "#", "#", "#", "#", "#", "#", "#", "#", "#", "#", "#"]]