[["#", "#", "#", "#", "#", "#", "#", "#", "#", "#", "#", "#", "#", "#", "#", "#", "#", "#", "#", "#", "#"],
 ["#", " ", " ", " ", " ", " ", " ", " ", " ", " ", " ", " ", "#", " ", " ", " ", " ", " ", " ", " ", "#"],
 ["#", "#", "#", "#", "#", "#", "#", "#", "#", "#", "#", " ", "#", " ", "#", " ", "#", "#", "#", " ", "#"],
 ["#", " ", " ", " ", " ", " ", " ", " ", " ", " ", "#", " ", "#", " ", " ", " ", "#", " ", " ", " ", "#"],
 ["#", " ", "#", " ", "#", "#", "#", "#", "#", "#", "#", " ", "#", " ", "#", "#", "#", " ", "#", " ", "#"],
 ["#", " ", "#", " ", "#", " ", " ", " ", "#", " ", " ", " ", "#", " ", " ", " ", " ", " ", "#", " ", "#"],
 ["#", " ", "#", "#", "#", " ", "#", " ", "#", " ", "#", "#", "#", " ", "#", " ", "#", "#", "#", " ", "#"],
 ["#", " ", " ", " ", " ", " ", "#", " ", "#", " ", " ", " ", " ", " ", "#", " ", " ", " ", " ", " ", "#"],
 ["#", " ", "#", " ", "#", "#", "#", " ", "#", "#", "#", "#", "#", " ", "#", " ", "#", " ", "#", "#", "#"],
 ["#", " ", "#", " ", "#", " ", " ", " ", " ", " ", " ", " ", "#", " ", "#", " ", " ", " ", " ", " ", "#"],
 ["#", " ", "#", " ", "#", " ", "#", "#", "#", " ", "#", " ", "#", " ", "#", " ", "#", "#", "#", " ", "#"],
 ["#", " ", "#", " ", "#", " ", "#", " ", " ", " ", "#", " ", " ", " ", "#", " ", "#", " ", " ", " ", "#"],
 ["#", " ", "#", " ", "#", " ", "#", "#", "#", "#", "#", " ", "#", "#", "#", "#", "#", " ", "#", " ", "#"],
 ["#", " ", "#", " ", "#", " ", " ", " ", " ", " ", " ", " ", "#", " ", " ", " ", " ", " ", "#", " ", "#"],
 ["#", " ", "#", " ", "#", "#", "#", "#", "#", " ", "#", "#", "#", " ", "#", " ", "#", " ", "#", " ", "#"],
 ["#", " ", "#", " ", " ", " ", " ", " ", " ", " ", " ", " ", " ", " ", " ", " ", "#", " ", "#", " ", "#"],
 ["#", " ", "#", " ", "#", "#", "#", " ", "#", " ", "#", "#", "#", "#", "#", "#", "#", " ", "#", " ", "#"],
 ["#", " ", "#", " ", " ", " ", "#", " ", "#", " ", " ", " ", "#", " ", " ", " ", "#", " ", " ", " ", "#"],
 ["#", " ", "#", "#", "#", " ", "#", " ", "#", "#", "#", " ", "#", " ", "#", " ", "#", " ", "#", "#", "#"],
 ["#", " ", " ", " ", " ", " ", "#", " ", " ", " ", " ", " ", "#", " ", "#", " ", " ", " ", " ", "E", "#"],
 ["#", "#", "#", "#", "#", "#", "#", "#", "#", "#", "#", "#", "#", "#", "#", "#", "#", "#", "#", "#", "#"]]