[["#", "#", "#", "#", "#", "#", "#", "#", "#", "#", "#", "#", "#", "#", "#", "#", "#", "#", "#", "#", "#"],
 ["#", " ", " ", " ", " ", " ", " ", " ", "#", " ", " ", " ", " ", " ", " ", " ", "#", " ", " ", " ", "#"],
 ["#", "#", "#", "#", "#", "#", "#", " ", "#", " ", "#", " ", "#", "#", "#", " ", "#", " ", "#", " ", "#"],
 ["#", " ", " ", " ", " ", " ", "#", " ", "#", " ", "#", " ", "#", " ", " ", " ", "#", " ", "#", " ", "#"],
 ["#", "#", "#", " ", "#", " ", "#", " ", "#", "#", "#", " ", "#", " ", "#", "#", "#", " ", "#", " ", "#"],
 ["#", " ", " ", " ", "#", " ", "#", " ", "#", " ", " ", " ", "#", " ", " ", " ", " ", " ", "#", " ", "#"],
 ["#", " ", "#", "#", "#", " ", "#", " ", "#", " ", "#", "#", "#", " ", "#", "#", "#", "#", "#", " ", "#"],
 ["#", " ", "#", " ", " ", " ", "#", " ", " ", " ", " ", " ", "#", " ", " ", " ", " ", " ", " ", " ", "#"],
 ["#", " ", "#", "#", "#", " ", "#", "#", "#", "#", "#", " ", "#", "#", "#", "#", "#", "#", "#", " ", "#"],
 ["#", " ", " ", " ", " ", " ", "#", " ", " ", " ", " ", " ", " ", " ", " ", " ", "#", " ", " ", " ", "#"],
 ["#", " ", "#", " ", "#", " ", "#", " ", "#", " ", "#", " ", "#", "#", "#", "#", "#", " ", "#", "#", "#"],
 ["#", " ", "#", " ", "#", " ", "#", " ", "#", " ", " ", " ", "#", " ", " ", " ", " ", " ", "#", " ", "#"],
 ["#", " ", "#", " ", "#", " ", "#", " ", "#", "#", "#", " ", "#", " ", "#", "#", "#", "#", "#", " ", "#"],
 ["#", " ", " ", " ", "#", " ", " ", " ", " ", " ", "#", " ", " ", " ", " ", " ", "#", " ", " ", " ", "#"],
 ["#", "#", "#", " ", "#", " ", "#", "#", "#", " ", "#", " ", "#", "#", "#", " ", "#", " ", "#", " ", "#"],
 ["#", " ", " ", " ", "#", " ", " ", " ", "#", " ", "#", " ", " ", " ", "#", " ", "#", " ", "#", " ", "#"],
 ["#", " ", "#", "#", "#", " ", "#", " ", "#", " ", "#", " ", "#", " ", "#", " ", "#", " ", "#", " ", "#"],
 ["#", " ", " ", " ", "#", " ", "#", " ", "#", " ", "#", " ", " ", " ", " ", " ", "#", " ", "#", " ", "#"],
 ["#", "#", "#", " ", "#", " ", "#", " ", "#", " ", "#", "#", "#", "#", "#", "#", "#", " ", "#", "#", "#"],
 ["#", " ", " ", " ", " ", " ", "#", " ", " ", " ", " ", " ", " ", " ", " ", " ", " ", " ", " ", "E", "#"],
 ["#", "#", "#", "#", "#", "#", "#", "#", "#", "#", "#", "#", "#", "#", "#", "#", "#", "#", "#", "#", "#"]]