[["#", "#", "#", "#", "#", "#", "#", "#", "#", "#", "#", "#", "#", "#", "#", "#", "#", "#", "#", "#", "#"],
 ["#", " ", " ", " ", "#", " ", " ", " ", " ", " ", "#", " ", " ", " ", " ", " ", " ", " ", "#", " ", "#"],
 ["#", "#", "#", " ", "#", "#", "#", " ", "#", " ", "#", " ", "#", " ", "#", "#", "#", " ", "#", " ", "#"],
 ["#", " ", "#", " ", "#", " ", " ", " ", "#", " ", " ", " ", "#", " ", "#", " ", " ", " ", " ", " ", " "],
 ["#", " ", "#", " ", "#", " ", "#", " ", "#", " ", "#", "#", "#", " ", "#", "#", "#", " ", "#", "#", "#"],
 ["#", " ", " ", " ", "#", " ", " ", " ", " ", " ", "#", " ", " ", " ", "#", " ", " ", " ", " ", " ", "#"],
 ["#", " ", "#", "#", "#", "#", "#", " ", "#", " ", "#", " ", "#", "#", "#", " ", "#", "#", "#", " ", "#"],
 ["#", " ", " ", " ", " ", " ", " ", " ", "#", " ", "#", " ", " ", " ", " ", " ", "#", " ", " ", " ", "#"],
 ["#", "#", "#", " ", "#", "#", "#", " ", "#", "#", "#", " ", "#", "#", "#", "#", "#", " ", "#", " ", "#"],
 ["#", " ", " ", " ", "#", " ", " ", " ", " ", " ", " ", " ", " ", " ", " ", " ", " ", " ", "#", " ", "#"],
 ["#", " ", "#", " ", "#", " ", "#", "#", "#", " ", "#", "#", "#", " ", "#", "#", "#", "#", "#", " ", "#"],
 ["#", " ", "#", " ", "#", " ", "#", " ", " ", " ", " ", " ", "#", " ", "#", " ", " ", " ", " ", " ", "#"],
 ["#", " ", "#", " ", "#", " ", "#", " ", "#", "#", "#", " ", "#", " ", "#", " ", "#", " ", "#", " ", "#"],
 ["#", " ", "#", " ", " ", " ", " ", " ", " ", " ", "#", " ", " ", " ", "#", " ", "#", " ", " ", " ", "#"],
 ["#", " ", "#", "#", "#", " ", "#", " ", "#", " ", "#", " ", "#", "#", "#", " ", "#", "#", "#", " ", "#"],
 ["#", " ", " ", " ", "#", " ", " ", " ", " ", " ", " ", " ", " ", " ", " ", " ", " ", " ", "#", " ", "#"],
 ["#", "#", "#", " ", "#", " ", "#", " ", "#", "#", "#", "#", "#", " ", "#", "#", "#", "#", "#", " ", "#"],
 ["#", " ", " ", " ", "#", " ", "#", " ", " ", " ", " ", " ", " ", " ", " ", " ", "#", " ", " ", " ", "#"],
 ["#", " ", "#", "#", "#", "#", "#", " ", "#", " ", "#", " ", "#", "#", "#", " ", "#", " ", "#", " ", "#"],
 ["#", " ", " ", " ", " ", " ", " ", " ", "#", " ", " ", " ", " ", " ", " ", " ", " ", " ", " ", "E", "#"],
 ["#", "#", "#", "#", "#", "#", "#", " ", "#", "#", "#", "#", "#", "#", "#", "#", "#", "#", "#", "#", "#"]]