[["#","#","#","#","#"],
 ["#"," "," "," ","#"],
 ["#"," "," "," ","#"],
 ["#"," "," ","E","#"],
 ["#","#","#","#","#"]]